XXXXXXXXXXXXXXXXXXXXXXXXXXXXXXXXXXXXXXXXXXXXX
X....P...............X.....K.........X......X
X....................X...............X......X
XXXXXXXXXXXXXXXXXX..XXXXXXXXXX.......X......X
X.K...........X........K.....X.......X......X
XXXXXXXXXXXXX.X..............X.......X......X
X.................0..O..0.0.................X
XXX......XXXXXXXXXX..XXXXXXXXXXXXXX..XXXXXXXX
X........X.............X....................X
XXXXXXXXXXXXXXXXXXXXXXXXXXXXXXXXXXXXXXXXXXXXX
