XXXXXXXXXXXXXXXXXXXXXXXXXXXXXXXXXXXXXXXXXXXXX
X....P...............X.....K.........X..0...X
X....................X...............X......X
XXXXXXXXXXXXXXXXXX..XXXXXXXXXX.......X......X
X.K...........X..............X.......X......X
XXXXXXXXXXXXX.X..............X.......X......X
X...........................................X
XXX......XXXXXXXXXX..XXXXXXXXXXXXXX..XXXXXXXX
X.0......X.............X.O..................X
XXXXXXXXXXXXXXXXXXXXXXXXXXXXXXXXXXXXXXXXXXXXX
